{
  "width": 13,
  "height": 11,
  "tiles": [
    "#############",
    "#P..*.*..A..#",
    "#.#.#.#.#.#.#",
    "#*.*.*.*.*.*#",
    "#.#.#.#.#.#.#",
    "#..B*.*..*..#",
    "#.#.#.#.#.#.#",
    "#*.*.*.*.*.*#",
    "#.#.#.#.#.#.#",
    "#..*..A..*..#",
    "#############"
  ]
}
